.....................................:  ....                ...  :.   .................      .   .  ..            ............ .:.     .                ..  :.....................................
................................... .:  ...                ...   :.  .................      .    . ..            ............. .:.    .                 ..  :. ...................................
................................... .:  .                 ..     :. ................       .    ..              .............. .:.   .                 ...  :. ...................................
................................... .:                   ..      :. ...............             ..             ............... .:.                    ....  :.    ................................
                                    .:                           :.                             ..                             .:.                          :.                                    
                                    .:                           :.                             ..                             .:                           :.                                    
                                    .:                           :.                                                            .:.                          :.                                    
                                    .:                           :.                                                            .:.                          :.                                    
                                    .:                           :.                                                            .:.                          :.                                    
                     ........       .:                           :.                                                            .:.                          :.                                    
                    ..........      .:                           :.                                                            .:.                          :.                                    
                   ................ .:                           :.                           .====.                           .:.                          :.                                    
           ..........................:                           :.                          :======:                          .:.                          :.                                    
          ...........................:.                          :.                          ========                          .:.                          :.                                    
          ...........................:..                         :.                            ....                            .:.      ..                  :.     .                         ..   
      ...............................:.......                    :.                                                            .:       ..                  :.    ..                         ..   
     ................................:........                   :.                                                            .:       ..                  :.    ..                         ..   
     ................................:........                   :.                                                            .:       .:......:..........::....:::::::::::::::::::.::::.::...   
       ............................:::.......                    :.                                                            .:       .:========================-:-========================:.   
       .................:::..     . .:..                         :.                                                            .:       .:========================-:-========================:.   
                 .-.    :::     .   .:                           :.                                                            .:       .:==-:--=-..--=====-:.:===-:-===:-::.....-===========:.   
                   .-   :::   ..    .:                           :.                                                            .:       .:.   ...     =--=-..  ..=-:--     ..    :=       .==:.   
                     .-:---::       .:                           :.                                                            .:       .:.    ..     :  . :.    =-:--     ..    :-        ==:.   
                       :---         .:                           :.                                                            .:       .:.   ...        . :.    =-:--     ..    :-        ==:.   
                        ---         .:                           :.                                                            .:       ::.   ...     .    ..   .=-:--     ..    :-        ==:.   
                        ---          :                           :.                                                            .:       .:.......................:::.............:...........:.   
                        ---          :                           :.                                                            .:       ::========================-:-========================:.   
                        ---          :                           :.                                                            .:       .:========================-:-========================:.   
                        ---          :                           :.                                                            .:       .:========================-:-====-:----=========---==:.   
                        ---          :                           :.                                                            .:       .:=.        -===- ..  .:==-:--:...       . :-==    ==:.   
                        ---         .:                           :.                                                            .:       .:=.        : ...  .    ---:-:.. .         . ..    ==:.   
                       .---.        .:                           :.                                                            .:       .:=.        -  ..  .      ::-:.. .         .       ==:.   
........................---..........:...........................::............................................................::........:=         :  ..  .    . -:-:.            ..      ==:....
.......................:---:.........:...........................::..........         ........................       ..........::........:-..      .:. ........ :.::::.............::......:::....
.....................................:...........................:.........         ........................          .........::........:------------------------:::------------------------:....
.....................................:...........................:........          ........................         ..........::........:========================-:-========================:....
.....................................:...........................:........           .......................          .........::........:=======--===============-:-================-::-::.-:....
.....................................:...........................:..........         .......................         ..........::........:=== ...    ==---:..::.:=-:-=:         .===:.. .   -:....
.....................................:...........................:........::::..:::::.::::::::::::::::::::::...:::::::.::......::........:= .   .      ..      ..=-:-=.            .  . .   -:....
.....................................:...........................:......:================================================:.....::........:+ .          ..      ..=-:-=          :  .  . .   -:....
..............::::::::::::::::::::::::::::::::::::::::::::::::...:.......:==============================================-......::........:=..          ..      ..=-:-=.         .  .. . .   ::....
.............-================================================...::......:===***+===+**+====***====***====+**+===+***===-......::........:=-:  ..      .       ..=::-=.         .  :. ...   ::....
....................::...=-..........:.............=-...::.......::......:===***+===+**+====***====***====+**+===+***===-......::........:.....:...::.................::::::::::::::::::.....:....
........................:=-..........:.............=-...::.......::......:===***+===+**+===+***====***====+**+===+***===-......::.......::========================-:-========================:....
....................:...:=:..........:.............-=............::......:===***+===+**+===+***====***====+**+===+***===-......::........:=====::==========-:::===-:-========================:....
....................:...-=...........:..............=............::......:===***+===+**+===+***====***====+**+===+***===-......::.......::=====  =========-..  ..:::-======-:......    .    ::....
........................--...........:..............=:...........:.......:===***+===+**+===+***====***====+**+===+***===-......::........:.   -  :       .-..    .::-=-  ::     ...    .    ::....
::::::::::::::::::::::::=-::::::::::::::::::::::::::=-:::::::::::::::::::====***+===+**+===+***====***====+**+===+***====:::::::::::::::::.   .  .        -..    .-:-.    .     ..     .    ::::::
 . ................:....=...........................:-....:..............-===***+===+**+===+***====***====+**+===+***===-...............::.   .  .       .-..    .-:-    ..     ..     .    ::....
                  ...  .-                           .-.  ...             -===***+===+**+===+***====***====+**+===+***===-              .:::   -           -..    .-:-:.        ....    .    ::..  
                  ..........................................             :==============================================-              ....::..:.::::::::.:......:::...:::.....::::.:......:.:..  
                  ..                                   .....            :++++++++++++++++++++++++++++++++++++++++++++++++:             ...........................:.........................::..  
                                                                                                                                       ...                        :..                      .-:..  
                                                                                                                                       ....         ..    ........:.........................-:..  
                                                                                                                                       .....................................................:...  
                                                                                                                                                                                                  
                                                                                                                                                                                                  
                                                                                                                                                                                                  
                                                                                                                                                                                                  
                                                                                                                                                                                                  
                                                                                                                                                                                                  
                                                                                                                                                                                                  
                                                                                                                                                                                                  
                                                                                                                                                                                                  
                                                                                                                                                                                                  
                                                                                                                      :                                                                           
                                                                   .        :                                                                                                                     
                                                                                                                                                                                                  