                                                                                .   ..............................................................................................................
---------------------------------------------------====:           ...............................................................................................................................
---------------------------------------------------====:..........................................................................................................................................
+++++++++++++++++++++++++++++++++++++++++++++++++++----.......................  .  ...............................................................................................................
+++++++++++++++++++++++++++++++++++++++++++++++++++--=-----------------------. ... ......................................................  ................. ................. . .................
===+==+++===++++++++++++++.......-===++++++++++++++--=-======================  ...........:--------------------.......................... . ...............  ................  ...................
:::-..:==........---=------==    .::::......---=--+--=-+++++++++++++++++++-   ............:-.................:-........................  ................  ................  . ...................
----........     :::.  ......    .---...    ::::  =--=-+=..=+=====+++++++   ..............:-.................:-.......................         ..........        ..........         ..............
===+--...:::.....===+--.::.......-====--....===+::+--=-----   .:::--....:            .   .:-.................:-...................................................................................
===+--:--:::.....====--:--.......-====-:....===+--+--=-....    ===..    -:- .=:...........:-....     ....... .-......-===-----------------------------------------==-.===-------------------------
-===--:--:::.....====--:--:::....:===--:....===+--+--=--:.....:=====....-==-=+--=.........:-..               .-......:--++++++++++++++++++++++++++++++++++++++++++--:.:--+++++++++++++++++++++++++
.:::  ......     ....  ...---    .:::.      ...:  =--=--:......=====....--=-=+---.........::                 .-......:--++++++++++++++++++++++++*::+++++++++++++++--:.:-=++++++++++++++++++++++++=
===+--:--:::.....====--:--.......-====-:....===+--+--=-..--    :....    ---..+--=.........::                 .-......:--+++::...::..--.....--=-----   .::....--=-+--:.:--*+=:....::..=-.....-----:
-----------------------------------------------------=-:... ...===--....--=.:+--=.........::                 .-......:--+....   ==-:....   ---........===:   --:.+--:.:--+....  .==:....:  .--....
-----------------------------------------------------=---------------------------.........::                 .-......:--+--:-...===-:-::...==+---:....====...--=-+--:.:--+-:::..:===---:-..:==--::
+++*+++++++++++++++....   =++++++++++++++++++++-::---=-=+++++++++++++++++++=+==-=.........::                 .-......:--+.:..   ::....... .:::...:-   :::.   --:.+--:.:-=+....  .::......  .::....
====+++---................ ...=======---=====++....--=-..---++++++==++++++=::==-=.........:-                 .-......:--+::::...===-::::...===:::.:...===-...--=:+--:.:--+:::....==-:::::...==::::
::::--:.......::::........    ..:::::....:::---:..:--=-..   ---::----::-==-::==-=.........:-    .            :-......:----------------------------------------------:.:---------------------------
===----.................  ....==============----::---=-..::-===---===------..==-=.........:-.................:-......:--++++++++++++++++++++:::..-+++++++++++++-:---:.:--++++++++++++++++++++.:...
-.==---................   ....=.:=-:-=.:=::-=:--::---=-..-:---=-.==-=:.+-:=..-=-=.........:--------------------......:--=::--:::----:............. .--::---::==-----:.:---:---:::--==.............
======-................   ....=================-::---=-..:::===========+++=::==-=....................................:--+======+==--:............:--======+====:.---:.:--==+=======--.............
::::::::::....:::::.......    ..:::::....::::::....--=-..   ---:::---::::::::==-=....................................:--+-==-=-=-=--:............:--===-===--=:-.---:.:-==-=-==-=-=--.............
===-==-................ ......===-=============-::---=------------------------=-=.....................................--=:::..::...::::..:::...... .--..:--..:::-=--:.:-=:.:...:..:::::...-::.....
-----------------------------------------------------=------------------------=-=.........................                       ----:::::::::::::--------------:---:.:--------------:::::::::::::
===================================================--=-+++=-+++==---++++++++++--=.........................                       +====+--=====++=====++++=========--:.:--===============--========
++====----:..:+++++++++++++===++++=====++++++++++++--=-.....:==...........-+++--=.........................                       ---...:.=+====+++::++-:::::::.=++--:.:--++===...----...--++====++
..::::.   .==----------.......-++:..::::....:::++++--=-   ..:--.:---.   .....+--=.........................                       .=-.........::   ..--..-:.  ...:+--:.:--+..::   .--- ........::  
..:---:..........  ::::    ....==...----    .....:+--=-...::-==-----....:::--+=-=..........................                      :==........-==...::==----:..:::-+--:.:--+-===...-===.....---===..
--====-::::.....:--==== ....:::==---====....:::...+--=-...::-==-----....:::--+=-=................... ......                      .-............................:-+--:.:--+:-=- ..:---...:::::-==..
--====-::::...-----====.....::-==---====....:::---+--=-   ...--  ...    .....+--=................... : ....                      .-.......... ..        ........:+=-:.:-=+.---   .-=-........---. 
----==-:::::::-----====.....::-==---====....:::---+--=-...::-==-----:...:::--+--=..................:==+....                      .-............         ....--------:.:---------------------------
  .:::.    --:...  ....    ....--. .::::    ......*--=------------------------=-=..................:==+............    -+************......+...                        --+**************++++++++++
--====-::::...::-:-====.....:::==---====....:::---+--=-++++++----:::--:::.:--=--=...................===.........         .::::::--::-.....:+...                        ---:::::::--:---=+***++++*+
-----------------------------------------------------=-=+***+                ==-=............-===========================================================================+*******##**##*+*+*++++++
===========+++++++++++++++++=====================+=--=----===::::...::.....::=--=..............-======================----===================---========================-++***++**#*****+***++*+*+
======+===+++++++++++++++++++++...................:--=-=++##*:-:-::::-.:...:-=--=..............-=====++++++++++++++==+----++++++++++++++++++==--=+++++++++++++++++=======-.:.:..:::.:::--===------
::::::::::=====================                    --=-=+*##*:---::::-.:...:-==--:::::::::::::::---===================---=====================--==================+---=---=======++=+=+===========
::::::::---..:......:......:......................:--=----++=                -=-=:::::::::::::::-=-====-------------==---===--------------====--==--------------==+=--=--:::::::::::::::::::::::::
=-=-==+=-=+====================...................---=-=+*##*:---::::-.:...:-==----------------:-=-====--------------+---===--------------====--==--------------==+=--=---------------------------
=-==--==-=+====================...................---=------------------------=-=...............-=-=+==---==-=-==----+---===----==-===----====--==----=======---==+=--===.........................
::::::-:::=====================                   .--=-.......................=--...............-=-=+==---==-=-=-----+---===-----====-----====--==-----=====----==+=---::::::::.:::::::::.::::::::
:::.:::::::::::::::::::::::::::                    --=-.......................---...............-=-=+==----====-===--+---===-----====-==--====--==-----====-==--==+=---...........................
==========+====================...................---=-::.::::::::::.::::::::-===-:::::::::.....-=-=+==---=-==-==----+---===----====-=-=--====--==----=-=====---==+=---...........................
-----------------------------------------------------=-::::::::::::.::::::::::-::::::::::::.....-=-====-------=------+---===-------=------====--==-------=------==+=---...........................
...................................................--=-.........................................-=-====-------------=+---====-------------====--==--------------==+=---...........................
...................................................----.........................................-=-===================---=====================--==================+=---...........................
:::::::.:::::::::::::.:::::::::::::.:::::::::::::.:====-::::::.:::..............................-=-=++++============++=--=+++=============++==--===============++++=---...........................
:::.:::::::::::::..:::::::::::::.:::::::::::::.::::====-:::::.::::..............................-=-----------------------------------------------------------------=---...........................
...............................................................................................:----...............................................................----...........................
...............................................................................................-====..............................................................-====:..........................
...............................................................................................-====..............................................................-====:..........................
..................................................................................................................................................................................................
..................................................................................................................................................................................................